"filename", "language", "Java", "comment", "blank", "total"
"c:\Users\kai\OneDrive - University of Dundee\Modules\Semester 1\AC11001 - Introduction to Software Development\Final Project\uerlichs_kai\Eclipse project folder\Reversi\src\ComputerPlayer.java", "Java", 47, 34, 18, 99
"c:\Users\kai\OneDrive - University of Dundee\Modules\Semester 1\AC11001 - Introduction to Software Development\Final Project\uerlichs_kai\Eclipse project folder\Reversi\src\Game.java", "Java", 425, 110, 94, 629
"c:\Users\kai\OneDrive - University of Dundee\Modules\Semester 1\AC11001 - Introduction to Software Development\Final Project\uerlichs_kai\Eclipse project folder\Reversi\src\Grid.java", "Java", 835, 154, 91, 1080
"c:\Users\kai\OneDrive - University of Dundee\Modules\Semester 1\AC11001 - Introduction to Software Development\Final Project\uerlichs_kai\Eclipse project folder\Reversi\src\HumanPlayer.java", "Java", 39, 22, 9, 70
"c:\Users\kai\OneDrive - University of Dundee\Modules\Semester 1\AC11001 - Introduction to Software Development\Final Project\uerlichs_kai\Eclipse project folder\Reversi\src\InputOutput.java", "Java", 132, 37, 24, 193
"c:\Users\kai\OneDrive - University of Dundee\Modules\Semester 1\AC11001 - Introduction to Software Development\Final Project\uerlichs_kai\Eclipse project folder\Reversi\src\Piece.java", "Java", 21, 28, 14, 63
"c:\Users\kai\OneDrive - University of Dundee\Modules\Semester 1\AC11001 - Introduction to Software Development\Final Project\uerlichs_kai\Eclipse project folder\Reversi\src\Player.java", "Java", 30, 44, 14, 88
"c:\Users\kai\OneDrive - University of Dundee\Modules\Semester 1\AC11001 - Introduction to Software Development\Final Project\uerlichs_kai\Eclipse project folder\Reversi\src\ReversiApp.java", "Java", 532, 155, 107, 794
"c:\Users\kai\OneDrive - University of Dundee\Modules\Semester 1\AC11001 - Introduction to Software Development\Final Project\uerlichs_kai\Eclipse project folder\Reversi\src\Statistic.java", "Java", 102, 61, 28, 191
"Total", "-", 2163, 645, 399, 3207